000000000000000000000000000000000000000000000
000000000000000000000000000000000000000000000
000000000000000000000000000000000000000000000
000000000000000000000000000000000000000000000
000000000000000000000000000000000000000000000
111111111111111111111111111111111111111111111
111111111111111111111111111111111111111111111
000000000000000000000000000000000000000000000
000000000000000000000000000000000000000000000
000000000000000000000000000000000000000000000
000044444444444444444444444444444444444440000
000044444444444444444444444444444444444440000
000044444444444444444444444444444444444440000
000044444444444444444444444444444444444440000
000000000000000000000000000000000000000000000
000000000000000000000000000000000000000000000
000000000000000011111222111110000000000000000
000000000000000010001222100010000000000000000
000044444444444412021000120214444444444440000
000044444444444412021000120214444444444440000
000044444444444412021000120214444444444440000
000000000000000012021000120210000000000000000
000000000000000012021000120210000000000000000
000044444444444412021000120214444444444440000
000044444444444412021000120214444444444440000
000044444444444412021000120214444444444440000
000000000000000012021000120210000000000000000
000000000000000012021000120210000000000000000
000044444444444412021000120214444444444440000
000044444444444412021000120214444444444440000
000044444444444412021000120214444444444440000
000000000000000012022000220210000000000000000
000000000000000012022000220210000000000000000
000000000000000012022000220210000000000000000
111111111111000012022000220210000111111111111
111111111111000012022000220210000111111111111
000000000000000012022000220210000000000000000
000000000000000012022000220210000000000000000
000000000000000012022000220210000000000000000
000000000000000012022000220210000000000000000
000000000000000012000000000210000000000000000
000000000000000012000000000210000000000000000
000000000000000012222222222210000000000000000
000000000000000012222222222210000000000000000
000000000000000011111111111110000000000000000
000000000000000000000000000000000000000000000
000000000000000000000000000000000000000000000
000000000000000000000000000000000000000000000
000000000000000000000000000000000000000000000
000000000000000000000000000000000000000000000
000000000000000000000000000000000000000000000
000000000000000000000000000000000000000000000
000000000000000000000000000000000000000000000
000000000000000000000000000000000000000000000
000000000000000000000000000000000000000000000
000000000000000000000000000000000000000000000
000000000000000000000000000000000000000000000
000000000000000000000000000000000000000000000
000000000000000000000000000000000000000000000
000000000000000000000000000000000000000000000
000000000000000000000000000000000000000000000
000000000000000000000000000000000000000000000
000000000000000000000000000000000000000000000
000000000000000000000000000000000000000000000
000000000000000000000000000000000000000000000
000000000000000000000000000000000000000000000
000000000000000000000000000000000000000000000
000000000000000000000000000000000000000000000
000000000000000000000000000000000000000000000
000000000000000000000000000000000000000000000
