000000000000000000000000000000000000000000000
000000000000000000000000000000000000000000000
000000000000000000000000000000000000000000000
222222222222222222222222222222222222000000000
000000000000000000000000000000000000000000000
000000000000000000000000000000000000000000000
222222222222222222222222222222222222000000000
000000000000000000000000000000000000000000000
000000000000000000000000000000000000000000000
222222222222222222222222222222222222000000000
000000000000000000000000000000000000000000000
000000000000000000000000000000000000000000000
222222222222222222222222222222222222000000000
000000000000000000000000000000000000000000000
000000000000000000000000000000000000000000000
222222222222222222222222222222222222000000000
000000000000000000000000000000000000000000000
000000000000000000000000000000000000000000000
222222222222222222222222222222222222000000000
000000000000000000000000000000000000000000000
000000000000000000000000000000000000000000000
222222222222222222222222222222222222000000000
000000000000000000000000000000000000000000000
000000000000000000000000000000000000000000000
222222222222222222222222222222222222000000000
000000000000000000000000000000000000000000000
000000000000000000000000000000000000000000000
222222222222222222222222222222222222000000000
000000000000000000000000000000000000000000000
000000000000000000000000000000000000000000000
222222222222222222222222222222222222000000000
000000000000000000000000000000000000000000000
000000000000000000000000000000000000000000000
111111111111111111111111111111111111111110000
000000000000000000000000000000000000000000000
000000000000000000000000000000000000000000000
000000000000000000000000000000000000000000000
000000000000000000000000000000000000000000000
000000000000000000000000000000000000000000000
000000000000000000000000000000000000000000000
000000000000000000000000000000000000000000000
000000000000000000000000000000000000000000000
000000000000000000000000000000000000000000000
000000000000000000000000000000000000000000000
000000000000000000000000000000000000000000000
000000000000000000000000000000000000000000000
000000000000000000000000000000000000000000000
000000000000000000000000000000000000000000000
000000000000000000000000000000000000000000000
000000000000000000000000000000000000000000000
000000000000000000000000000000000000000000000
000000000000000000000000000000000000000000000
000000000000000000000000000000000000000000000
000000000000000000000000000000000000000000000
000000000000000000000000000000000000000000000
000000000000000000000000000000000000000000000
000000000000000000000000000000000000000000000
000000000000000000000000000000000000000000000
000000000000000000000000000000000000000000000
000000000000000000000000000000000000000000000
000000000000000000000000000000000000000000000
000000000000000000000000000000000000000000000
000000000000000000000000000000000000000000000
000000000000000000000000000000000000000000000
000000000000000000000000000000000000000000000
000000000000000000000000000000000000000000000
000000000000000000000000000000000000000000000
000000000000000000000000000000000000000000000
000000000000000000000000000000000000000000000
000000000000000000000000000000000000000000000
