000000000000000000000000000000000000000000000
111111111111111111111111111111111111000000000
111111111111111111111111111111111111000000000
000000000000000000000000000000000011000000000
000000000000000000000000000000000011000000000
000000000000000000000000000000000011000000000
222222222222222222222222222222200011000000000
222222222222222222222222222222200011000000000
222222222222222222222222222222200011000000000
222222222222222222222222222222200011000000000
222222222222222222222222222222200011111111111
222222222222222222222222222222200011111111111
222222222222222222222222222222200011440004411
222222222222222222222222222222200011440004411
222222222222222222222222222222200011004440011
222222222222222222222222222222200011004440011
222222222222222222222222222222200011004440011
222222222222222222222222222222200011444440011
222222222222222222222222222222200011444440011
222222222222222222222222222222200011114440011
222222222222222222222222222222200011114440011
222222222222222222222222222222200000004440011
222222222222222222222222222222200000004440011
222222002222222002222222002222200011114440011
222222002222222002222222002222200011114440011
222222002222222002222222002222200011444440011
222222002222222002222222002222200011444440011
222222002222222002222222002222200011004440011
222222002222222002222222002222200011004440011
222222002222222002222222002222200011004440011
222222002222222002222222002222200011440004411
222222002222222002222222002222200011440004411
222222002222222002222222002222200011111111111
222222002222222002222222002222200011111111111
222222002222222002222222002222200011000000000
222222002222222002222222002222200011000000000
222222002222222002222222002222200011000000000
222222002222222002222222002222200011000000000
000000000000000000000000000000000011000000000
000000000000000000000000000000000011000000000
000000000000000000000000000000000011000000000
000001111111111111111111111111111111000000000
000001111111111111111111111111111111000000000
000000000000000000000000000000000000000000000
000000000000000000000000000000000000000000000
000000000000000000000000000000000000000000000
000000000000000000000000000000000000000000000
000000000000000000000000000000000000000000000
000000000000000000000000000000000000000000000
000000000000000000000000000000000000000000000
000000000000000000000000000000000000000000000
000000000000000000000000000000000000000000000
000000000000000000000000000000000000000000000
000000000000000000000000000000000000000000000
000000000000000000000000000000000000000000000
000000000000000000000000000000000000000000000
000000000000000000000000000000000000000000000
000000000000000000000000000000000000000000000
000000000000000000000000000000000000000000000
000000000000000000000000000000000000000000000
000000000000000000000000000000000000000000000
000000000000000000000000000000000000000000000
000000000000000000000000000000000000000000000
000000000000000000000000000000000000000000000
000000000000000000000000000000000000000000000
000000000000000000000000000000000000000000000
000000000000000000000000000000000000000000000
000000000000000000000000000000000000000000000
000000000000000000000000000000000000000000000
000000000000000000000000000000000000000000000
