000000000000000000000000000000000000000000000
000000000000000000000000000000000000000000000
000000000000000000000000000000000000000000000
000000000000000000000000000000000000000000000
000000000000000000000000000000000000000000000
000044444444444444444444444444444444444440000
000044444444444444444444444444444444444440000
000044444444444444444444444444444444444440000
000000000000000000000000000000000000000000000
000000000000000000000000000000000000000000000
000000000000000000000000000000000000000000000
000044444444444444444444444444444444444440000
000044444444444444444444444444444444444440000
000044444444444444444444444444444444444440000
000000000000000000000000000000000000000000000
000000000000000000000000000000000000000000000
000000000000000000000000000000000000000000000
000044444444444444444444444444444444444440000
000044444444444444444444444444444444444440000
000044444444444444444444444444444444444440000
000000000000000000000000000000000000000000000
000000000000000000000000000000000000000000000
000000000000000000000000000000000000000000000
000044444444444444444444444444444444444440000
000044444444444444444444444444444444444440000
000044444444444444444444444444444444444440000
000000000000000000000000000000000000000000000
000000000000000000000000000000000000000000000
000000000000000000000000000000000000000000000
000011111111111111111111111111111001111111110
000011111111111111111111111111111001111111110
000000000000000000000000000000011001100000000
000000000000000000000000000000011001100000000
000000000000000000000000000000011001100000000
000000000000000000000000000000011001100000000
000000000000000000000000000000011001100000000
000000000000000000000000000111111001111110000
000000000000000000000000000111111001111110000
000000000000000000000000000110222002220110000
000000000000000000000000000112222002222110000
000000000000000000000000000112222222222110000
000000000000000000000000000112222222222110000
000000000000000000000000000110222222220110000
000000000000000000000000000111111111111110000
000000000000000000000000000111111111111110000
000000000000000000000000000000000000000000000
000000000000000000000000000000000000000000000
000000000000000000000000000000000000000000000
000000000000000000000000000000000000000000000
000000000000000000000000000000000000000000000
000000000000000000000000000000000000000000000
000000000000000000000000000000000000000000000
000000000000000000000000000000000000000000000
000000000000000000000000000000000000000000000
000000000000000000000000000000000000000000000
000000000000000000000000000000000000000000000
000000000000000000000000000000000000000000000
000000000000000000000000000000000000000000000
000000000000000000000000000000000000000000000
000000000000000000000000000000000000000000000
000000000000000000000000000000000000000000000
000000000000000000000000000000000000000000000
000000000000000000000000000000000000000000000
000000000000000000000000000000000000000000000
000000000000000000000000000000000000000000000
000000000000000000000000000000000000000000000
000000000000000000000000000000000000000000000
000000000000000000000000000000000000000000000
000000000000000000000000000000000000000000000
000000000000000000000000000000000000000000000
