333333333333333333333333333333333333333333333
333333333333333333333333333333333333333333333
000111000111000111000111000111000111000111000
000111000111000111000111000111000111000111000
000111000111000111000111000111000111000111000
444444444444444444444444444444444444444444444
444444444444444444444444444444444444444444444
444444444444444444444444444444444444444444444
000000000000000000000000000000000000000000000
000000000000000000000000000000000000000000000
111000111000111000111000111000111000111000111
111000111000111000111000111000111000111000111
111000111000111000111000111000111000111000111
000000000000000000000000000000000000000000000
000000000000000000000000000000000000000000000
000000000000000000000000000000000000000000000
044444444444444444444444444444444444444444440
044444444444444444444444444444444444444444440
000111000111000111000111000111000111000111000
000111000111000111000111000111000111000111000
000111000111000111000111000111000111000111000
000000000000000000000000000000000000000000000
000000000000000000000000000000000000000000000
000000000000000000000000000000000000000000000
000000000000000000000000000000000000000000000
000000000000000000000000000000000000000000000
111000111000111000111000111000111000111000111
111000111000111000111000111000111000111000111
111000111000111000111000111000111000111000111
000000000000000000000000000000000000000000000
000000000000000000000000000000000000000000000
000000000000000000000000000000000000000000000
000000000000000000000000000000000000000000000
000000000000000000000000000000000000000000000
022222222222222222222000222222222222222222220
022222222222222222222000222222222222222222220
022222222222222222222000222222222222222222220
022222222222222222222000222222222222222222220
022222222222222222222000222222222222222222220
022222222222222222222000222222222222222222220
022222222222222222222000222222222222222222220
022222222222222222222000222222222222222222220
022222222222222222222000222222222222222222220
011111111111111111111000111111111111111111110
011111111111111111111000111111111111111111110
000000000000000000000000000000000000000000000
000000000000000000000000000000000000000000000
000000000000000000000000000000000000000000000
000000000000000000000000000000000000000000000
000000000000000000000000000000000000000000000
000000000000000000000000000000000000000000000
000000000000000000000000000000000000000000000
000000000000000000000000000000000000000000000
000000000000000000000000000000000000000000000
000000000000000000000000000000000000000000000
000000000000000000000000000000000000000000000
000000000000000000000000000000000000000000000
000000000000000000000000000000000000000000000
000000000000000000000000000000000000000000000
000000000000000000000000000000000000000000000
000000000000000000000000000000000000000000000
000000000000000000000000000000000000000000000
000000000000000000000000000000000000000000000
000000000000000000000000000000000000000000000
000000000000000000000000000000000000000000000
000000000000000000000000000000000000000000000
000000000000000000000000000000000000000000000
000000000000000000000000000000000000000000000
000000000000000000000000000000000000000000000
000000000000000000000000000000000000000000000
