000000000000000000000000000000000000000000000
000000000000000000000000000000000000000000000
000000000000000000000000000000000000000000000
000000000000000000000000000000000000000000000
000000000000000000000000000000000000000000000
000000000000000000000000000000000000000000000
000000000000000000000000000000000000000000000
000000000000000000000000000000000000000000000
000000000000000000000000000000000000000000000
000000000000000000000000000000000000000000000
000000000000000000000000000000000000000000000
000000000000000000000000000000000000000000000
000000000000000000000000000000000000000000000
000000000000000000000000000000000000000000000
111111111111111111111111111111111111111111111
111111111111111111111111111111111111111111111
000000044444444444444444444444444444440000000
000000044444444444444444444444444444440000000
000000044444444444444444444444444444440000000
000222200000000000000000000000000000002222000
000222200000000000000000000000000000002222000
000222200000000000104404401000000000002222000
000222200000000000104404401000000000002222000
000222200000000011104404401110000000002222000
000222200000000000004404400000000000002222000
000222200000000044444404444440000000002222000
000222200000000044444404444440000000002222000
000222200000000000000000000000000000002222000
000222200111100044444404444440001111002222000
000222200111100044444404444440001111002222000
000222200110000000004404400000000011002222000
000222200110000011104404401110000011002222000
000222200110000000104404401000000011002222000
000222200110000000104404401000000011002222000
000222200110000000000000000000000011002222000
000222200110000000000000000000000011002222000
000222200110000000000000000000000011002222000
000222200110000000000000000000000011002222000
000222200110000000000000000000000011002222000
000222200110000000000000000000000011002222000
000222200110000000000000000000000011002222000
000000000110000000000000000000000011000000000
000000000110000000000000000000000011000000000
011111111110000000000000000000000011111111110
011111111110000000000000000000000011111111110
000000000000000000000000000000000000000000000
000000000000000000000000000000000000000000000
000000000000000000000000000000000000000000000
000000000000000000000000000000000000000000000
000000000000000000000000000000000000000000000
000000000000000000000000000000000000000000000
000000000000000000000000000000000000000000000
000000000000000000000000000000000000000000000
000000000000000000000000000000000000000000000
000000000000000000000000000000000000000000000
000000000000000000000000000000000000000000000
000000000000000000000000000000000000000000000
000000000000000000000000000000000000000000000
000000000000000000000000000000000000000000000
000000000000000000000000000000000000000000000
000000000000000000000000000000000000000000000
000000000000000000000000000000000000000000000
000000000000000000000000000000000000000000000
000000000000000000000000000000000000000000000
000000000000000000000000000000000000000000000
000000000000000000000000000000000000000000000
000000000000000000000000000000000000000000000
000000000000000000000000000000000000000000000
000000000000000000000000000000000000000000000
000000000000000000000000000000000000000000000
