000000000000000000000000000000000000000000000
000000000000000000000000000000000000000000000
000000000000000000000000000000000000000000000
000000000000000000000000000000000000000000000
000000000000000000000000000000000000000000000
000000000000000000000000000000000000000000000
000000000000000000000000000000000000000000000
000000000000000000000000000000000000000000000
011111111111111111111111111111111111111111110
011111111111111111111111111111111111111111110
011111111111111111111111111111111111111111110
011002222200222220000000044444444444444444440
011002222200222220000000044444444444444444440
011002222200222220000000000000000000000000000
011002222200222220000000000000000000000000000
011002222200222220000000044444444444444444440
011002222200222220000000044444444444444444440
011002222200222220000000011111111111111111110
011002222200222220000000011111111111111111110
011002222200222220000000044444444444444444440
011002222200222220000000044444444444444444440
011002222200222220011000000000000000000000000
011002222200222220011000000000000000000000000
011002222200222220011000044444444444444444440
011002222200222220011000044444444444444444440
011002222200222220011000000000000000000000000
011002222200222220011000000000000000000000000
011002222200222220011000044444444444444444440
011002222200222220011000044444444444444444440
011002222200222220011000000000000000000000000
011002222200222220011000000000000000000000000
011002222200222220011000044444444444444444440
011002222200222220011000044444444444444444440
011002222200222220011000011111111111111111110
011002222200222220011000011111111111111111110
011002222200222220011000000000000000000000000
011002222200222220011000000000000000000000000
011002222200222220011000000000000000000000000
011002222200222220011000000000000000000000000
011002222200222220011000000000000000000000000
011000000000000000011000000000000000000000000
011111111111111111111000000000000000000000000
011111111111111111111000000000000000000000000
000000000000000000000000000000000000000000000
000000000000000000000000000000000000000000000
000000000000000000000000000000000000000000000
000000000000000000000000000000000000000000000
000000000000000000000000000000000000000000000
000000000000000000000000000000000000000000000
000000000000000000000000000000000000000000000
000000000000000000000000000000000000000000000
000000000000000000000000000000000000000000000
000000000000000000000000000000000000000000000
000000000000000000000000000000000000000000000
000000000000000000000000000000000000000000000
000000000000000000000000000000000000000000000
000000000000000000000000000000000000000000000
000000000000000000000000000000000000000000000
000000000000000000000000000000000000000000000
000000000000000000000000000000000000000000000
000000000000000000000000000000000000000000000
000000000000000000000000000000000000000000000
000000000000000000000000000000000000000000000
000000000000000000000000000000000000000000000
000000000000000000000000000000000000000000000
000000000000000000000000000000000000000000000
000000000000000000000000000000000000000000000
000000000000000000000000000000000000000000000
000000000000000000000000000000000000000000000
000000000000000000000000000000000000000000000
