333333333333333333333333333333333333300000000
002003004005002003004005002003004005000000000
002003004005002003004005002003004005000000000
222222222222222223224225222223224225200000000
002003004005002003004005002003004005000000000
002003004005002003004005002003004005000000000
552553554555552553554555552553554555500000000
002003004005002003004005002003004005000000000
002003004005002003004005002003004005000000000
442443444445442443444445442443444445400000000
002003004005002003004005002003004005000000000
002003004005002003004005002003004005000000000
332333334335332333334335332333334335300000000
002003004005002003004005002003004005000111000
002003004005002003004005002003004005000111000
222223224225222223224225222223224225200111000
002003004005002003004005002003004005000111000
002003004005002003004005002003004005000111000
552553554555552553554555552553554555500111000
002003004005002003004005002003004005000111000
002003004005002003004005002003004005000111000
442443444445442443444445442443444445400111000
002003004005002003004005002003004005000111000
002003004005002003004005002003004005000111000
332333334335332333334335332333334335300111000
002003004005002003004005002003004005000111000
002003004005002003004005002003004005000111000
222223224225222223224225222223224225200111000
002003004005002003004005002003004005000111000
002003004005002003004005002003004005000111000
552553554555552553554555552553554555500111000
002003004005002003004005002003004005000111000
002003004005002003004005002003004005000111000
442443444445442443444445442443444445400111000
002003004005002003004005002003004005000111000
002003004005002003004005002003004005000111000
332333334335332333334335332333334335300111000
002003004005002003004005002003004005000111000
002003004005002003004005002003004005000111000
222223224225222223224225222223224225200111000
002003004005002003004005002003004005000111000
002003004005002003004005002003004005000111000
111111111111111111111111111111111111111111000
111111111111111111111111111111111111111111000
000000000000000000000000000000000000000000000
000000000000000000000000000000000000000000000
000000000000000000000000000000000000000000000
000000000000000000000000000000000000000000000
000000000000000000000000000000000000000000000
000000000000000000000000000000000000000000000
000000000000000000000000000000000000000000000
000000000000000000000000000000000000000000000
000000000000000000000000000000000000000000000
000000000000000000000000000000000000000000000
000000000000000000000000000000000000000000000
000000000000000000000000000000000000000000000
000000000000000000000000000000000000000000000
000000000000000000000000000000000000000000000
000000000000000000000000000000000000000000000
000000000000000000000000000000000000000000000
000000000000000000000000000000000000000000000
000000000000000000000000000000000000000000000
000000000000000000000000000000000000000000000
000000000000000000000000000000000000000000000
000000000000000000000000000000000000000000000
000000000000000000000000000000000000000000000
000000000000000000000000000000000000000000000
000000000000000000000000000000000000000000000
000000000000000000000000000000000000000000000
000000000000000000000000000000000000000000000
