000000000000000000000000000000000000000000000
000000000000000000000000000000000000000000000
000000000000000000000000000000000000000000000
222222222222222222222000222222222222222222222
222222222222222222222000222222222222222222222
222222222222222222222000222222222222222222222
222222222222222222222000222222222222222222222
000000000000000000000000000000000000000000000
000000000000000000000000000000000000000000000
000000000000000000000000000000000000000000000
111111111111111111110000011111111111111111111
111111111111111111110000011111111111111111111
444444444444444444440000044444444444444444444
444444444444444444440000044444444444444444444
444444444444444444440000044444444444444444444
444444444444444444440000044444444444444444444
444444444444444400000000000004444444444444444
444444444444444400000000000004444444444444444
444444444444444400000000000004444444444444444
444444444444444400000000000004444444444444444
444444444444444400000000000004444444444444444
444444444444000000000000000000000444444444444
444444444444000000000000000000000444444444444
444444444444000000000000000000000444444444444
444444444444000000000000000000000444444444444
444444444444000000000000000000000444444444444
444444444000000000000000000000000000444444444
444444444000000000000000000000000000444444444
444444444000000000000000000000000000444444444
444444444000000000000000000000000000444444444
111111111000000000000000000000000000111111111
111111111000000000000000000000000000111111111
111111111000000000000000000000000000111111111
111111111000000044444444444440000000111111111
111111111000000044444444444440000000111111111
111111111000000044444444444440000000111111111
111111111000000044444444444440000000111111111
111111111000000044444444444440000000111111111
111111111000000000000000000000000000111111111
111111111000000000000000000000000000111111111
111111111000000000000000000000000000111111111
111111111000000000000000000000000000111111111
111111111000000000000000000000000000111111111
111111111000000000000000000000000000111111111
111111111000000000000000000000000000111111111
000000000000000000000000000000000000000000000
000000000000000000000000000000000000000000000
000000000000000000000000000000000000000000000
000000000000000000000000000000000000000000000
000000000000000000000000000000000000000000000
000000000000000000000000000000000000000000000
000000000000000000000000000000000000000000000
000000000000000000000000000000000000000000000
000000000000000000000000000000000000000000000
000000000000000000000000000000000000000000000
000000000000000000000000000000000000000000000
000000000000000000000000000000000000000000000
000000000000000000000000000000000000000000000
000000000000000000000000000000000000000000000
000000000000000000000000000000000000000000000
000000000000000000000000000000000000000000000
000000000000000000000000000000000000000000000
000000000000000000000000000000000000000000000
000000000000000000000000000000000000000000000
000000000000000000000000000000000000000000000
000000000000000000000000000000000000000000000
000000000000000000000000000000000000000000000
000000000000000000000000000000000000000000000
000000000000000000000000000000000000000000000
000000000000000000000000000000000000000000000
