111111111111111111111111111111111111111111111
111111111111111111111111111111111111111111111
100000000000000000000000000000000000000000001
100000000000000000000000000000000000000000001
100000000000000000000000000000000000000000001
100000000000000000000000000000000000000000001
100000000000000000000000000000000000000000001
100000111111110000000000000000011111111000001
100000111111110000000000000000011111111000001
100000111111110000000000000000011111111000001
100000111111110000000000000000011111111000001
100000111111110000000000000000011111111000001
100000111111110000000000000000011111111000001
100000111111110000000000000000011111111000001
100000111111110000000000000000011111111000001
100000111111110000000000000000011111111000001
100000111111110000555505555000011111111000001
100000111111110000004000400000011111111000001
100000111111110000004000400000011111111000001
100000111111110000004000400000011111111000001
100000111111110000004000400000011111111000001
100000111111110000004000400000011111111000001
100000111111110003004000400300011111111000001
100000111111110003004000400300011111111000001
100000111111110003222000222300011111111000001
100000111111110003005000500300011111111000001
100000111111110003005000500300011111111000001
100000111111110000005000500000011111111000001
100000111111110000005000500000011111111000001
100000111111114400005000500004411111111000001
100000111111110400005000500004011111111000001
100000111111110400005000500004011111111000001
100000111111114440005000500044411111111000001
100000111111110040005000500040011111111000001
100000111111110040005000500040011111111000001
100000111111113040005000500040311111111000001
100000111111110330005000500033011111111000001
100000111111110030005000500030011111111000001
100000111111112003305000503300211111111000001
100000111111110200305000503002011111111000001
100000111111110020033000330020011111111000001
100000111111110002003000300200011111111000001
100000111111110000200303002000011111111000001
100000111111111111111111111111111111111000001
100000111111111111111111111111111111111000001
000000000000000000000000000000000000000000000
000000000000000000000000000000000000000000000
000000000000000000000000000000000000000000000
000000000000000000000000000000000000000000000
000000000000000000000000000000000000000000000
000000000000000000000000000000000000000000000
000000000000000000000000000000000000000000000
000000000000000000000000000000000000000000000
000000000000000000000000000000000000000000000
000000000000000000000000000000000000000000000
000000000000000000000000000000000000000000000
000000000000000000000000000000000000000000000
000000000000000000000000000000000000000000000
000000000000000000000000000000000000000000000
000000000000000000000000000000000000000000000
000000000000000000000000000000000000000000000
000000000000000000000000000000000000000000000
000000000000000000000000000000000000000000000
000000000000000000000000000000000000000000000
000000000000000000000000000000000000000000000
000000000000000000000000000000000000000000000
000000000000000000000000000000000000000000000
000000000000000000000000000000000000000000000
000000000000000000000000000000000000000000000
000000000000000000000000000000000000000000000
