000000000000000000000000000000000000000002000
000000000000000000000000000000000000000002000
000000000000000000000000000000000000000002000
000000000000000000000000000000000000000002000
333311111111111111111111111111111111111111000
000010000000000000000000000000000000200001000
000010000000000000000000000000000000200001000
000010000000000000000000000000000000200001000
000010000000000000000000000000000000200001000
000013333111111111111111111111111111100001000
000010000100000000000000000000020000100001000
000010000100000000000000000000020000100001000
000010000100000000000000000000020000100001000
000010000100000000000000000000020000100001000
000010000133331111111111111111110000100001000
000010000100001000000000002000010000100001000
000010000100001000000000002000010000100001000
000010000100001000000000002000010000100001000
000010000100001000000000002000010000100001000
000010000100001333311111111000010000100001000
000010000100001000010000001000010000100001000
000010000100001000010000001000010000100001000
000010000100001000010000001000010000100001000
000010000100001000010000001000010000100001000
000010000100001000011155551000010000100001000
000010000100001000040000001000010000100001000
000010000100001000040000001000010000100001000
000010000100001000040000001000010000100001000
000010000100001000040000001000010000100001000
000010000100001111111111111555510000100001000
000010000100004000000000000000010000100001000
000010000100004000000000000000010000100001000
000010000100004000000000000000010000100001000
000010000100004000000000000000010000100001000
000010000111111111111111111111115555100001000
000010000400000000000000000000000000100001000
000010000400000000000000000000000000100001000
000010000400000000000000000000000000100001000
000010000400000000000000000000000000100001000
000011111111111111111111111111111111155551000
000040000000000000000000000000000000000001000
000040000000000000000000000000000000000001000
000040000000000000000000000000000000000001000
000040000000000000000000000000000000000001000
111111111111111111111111111111111111111111000
000000000000000000000000000000000000000000000
000000000000000000000000000000000000000000000
000000000000000000000000000000000000000000000
000000000000000000000000000000000000000000000
000000000000000000000000000000000000000000000
000000000000000000000000000000000000000000000
000000000000000000000000000000000000000000000
000000000000000000000000000000000000000000000
000000000000000000000000000000000000000000000
000000000000000000000000000000000000000000000
000000000000000000000000000000000000000000000
000000000000000000000000000000000000000000000
000000000000000000000000000000000000000000000
000000000000000000000000000000000000000000000
000000000000000000000000000000000000000000000
000000000000000000000000000000000000000000000
000000000000000000000000000000000000000000000
000000000000000000000000000000000000000000000
000000000000000000000000000000000000000000000
000000000000000000000000000000000000000000000
000000000000000000000000000000000000000000000
000000000000000000000000000000000000000000000
000000000000000000000000000000000000000000000
000000000000000000000000000000000000000000000
000000000000000000000000000000000000000000000
