000000000000000000000000000000000000000000000
000000000000000000000000000000000000000000000
000000000000000000000000000000000000000000000
000000000000000000000000000000000000000000000
000000000000000000000000000000000000000000000
000002222222222222222222222222200000000000000
000002222222222222222222222222211111111111111
000002222222222222222222222222211111111111111
000002222222222222222222222222211111111111111
000002222222222222222222222222211111111111111
000112222222222222222222222222211111111111111
000112222222222222222222222222211111111111111
000112222222222222222222222222211111111111111
000112222222222222222222222222211111111111111
000112222222222222222222222222211111111111111
000112222222222222222222222222211111111111111
000112222222222222222222222222211111111111111
000112222222222222222222222222211111111111111
000112222222222222222222222222211111111111111
000112222222222222222222222222211111111111111
000112222222222222222222222222211111111111111
000112222222222222222222222222211111111111111
000112222222222222222222222222211111111111111
000112222222222222222222222222211111111111111
000112222222222222222222222222211111111111111
000112222222222222222222222222211111111111111
000112222222222222222222222222211111111111111
000112222222222222222222222222211111111111111
000112222222222222222222222222211111111111111
000112222222222222222222222222211111111111111
000112222222222222222222222222211111111111111
000112222222222222222222222222211111111111111
000112222222222222222222222222211111111111111
000112222222222222222222222222211111111111111
000112222222222222222222222222211111111111111
000112222222222222222222222222211111111111111
000112222222222222222222222222211111111111100
000112222222222222222222222222211111111111100
000002222222222222222222222222211111111111100
000002222222222222222222222222211111111111100
000002222222222222222222222222211111111111100
000002222222222222222222222222211111111111100
000002222222222222222222222222200000000000000
000002222222222222222222222222200000000000000
000000000000000000000000000000000000000000000
000000000000000000000000000000000000000000000
000000000000000000000000000000000000000000000
000000000000000000000000000000000000000000000
000000000000000000000000000000000000000000000
000000000000000000000000000000000000000000000
000000000000000000000000000000000000000000000
000000000000000000000000000000000000000000000
000000000000000000000000000000000000000000000
000000000000000000000000000000000000000000000
000000000000000000000000000000000000000000000
000000000000000000000000000000000000000000000
000000000000000000000000000000000000000000000
000000000000000000000000000000000000000000000
000000000000000000000000000000000000000000000
000000000000000000000000000000000000000000000
000000000000000000000000000000000000000000000
000000000000000000000000000000000000000000000
000000000000000000000000000000000000000000000
000000000000000000000000000000000000000000000
000000000000000000000000000000000000000000000
000000000000000000000000000000000000000000000
000000000000000000000000000000000000000000000
000000000000000000000000000000000000000000000
000000000000000000000000000000000000000000000
000000000000000000000000000000000000000000000
